...........
W.........W
WW.......WW
WWW.....WWW
WWWW...WWWW
WWWWWPWWWWW
WWWW...WWWW
WWW.....WWW
WW.......WW
W.........W
...........
