MW.W.M..B..
...WWW..W..
WWBW.WBBWWW
.W...W.....
...WWW..WWW
BWWW..M....
....BWWWWWW
.M.....W.P.
..WDW..W...
.WW.WWWW...
.......B...