..........M
.....R.....
.....D.....
...........
...........
PUR..W..LD.
...........
...........
.....U.....
.....L.....
..........M