P.....W.W..
WWW.W.W.W..
..W.W......
..WWWBW..W.
..W...W.WW.
..W.WBW.W..
..W.WWW.WW.
..W..BW.W..
.WWWWWWWW.W
.BB..WW....
.BB...B....
