.....M.....
W.........W
WW.......WW
WWR.....LWW
WWWW...WWWW
WWWWWPWWWWW
WWWW...WWWW
WWR.....LWW
WW.......WW
W.........W
.....M.....
