.....M.....
W.........W
WW.......WW
WWF.....FWW
WWWW...WWWW
WWWWWPWWWWW
WWWW...WWWW
WWF.....FWW
WW.......WW
W.........W
.....M.....
