..........M
.....B.....
..FWWWWWF..
.....B.....
....WWW....
P....M.....
....WWW....
.....B.....
..FWWWWWF..
.....B.....
..........M