P.....WMW..
WWW.W.W.W..
..W.W......
..WWWBW..W.
..W...W.WW.
..W.WBW.W..
..W.WWW.WW.
..W..BWMW..
.WWWWWWWW.W
.BB..WW....
.BB.G.B....