.W.W....B..
...WWW..W..
WWBW.WBBWWW
.W...W.....
...WWW..WWW
BWWW.......
....BWWWWWW
.......W.P.
..WWW..W...
.WW.WWWW...
.......B...
