MW.W.M..B..
...WWW..W..
WWBW.WBBWWW
.W...W.....
...WWW..WWW
BWWW..M....
....BWWWWWW
.M.....W.P.
..WWW..W...
.WW.WWWW...
.......B...