P.....WDW..
WWW.W.W.W..
M.W.W......
..WWWBW..W.
..W...W.WW.
..W.WBW.R..
..W.WWW.WW.
..W..BWMW..
.WWWWWWWW.W
.BB..DW....
.BB.G.B....