..........M
.....B.....
..UWWWWWU..
.....B.....
....WWW....
P....M.....
....WWW....
.....B.....
..DWWWWWD..
.....B.....
..........M