...........
.....B.....
..WWWWWWW..
.....B.....
....WWW....
P..........
....WWW....
.....B.....
..WWWWWWW..
.....B.....
...........
