.....B.....
BBBBWWWBBBB
.....W.....
.....W.....
.....W.....
.....W.....
.....W.....
.....W.....
...WWWWW...
..WWW.WWW..
PWWWW.WWWW.
