.G...B...G.
BBBBWWWBBBB
.....W.....
.....W.....
.M...W.....
.....W.....
.....W.....
.....W.....
...WWWWW.M.
..WWW.WWW..
PWWWW.WWWW.
