M....B.....
.....B.....
..WWWWWWW..
.....B.....
....WWW....
B....P....B
....WWW....
.....B.....
..WWWWWWW..
.....B.....
.....B.....