WWWWWWWWWWWWW
W...........W
W.....B.....W
W..WWWWWWW..W
W.....B.....W
W....WWW....W
WJ..........W
W....WWW....W
W.....B.....W
W..WWWWWWW..W
W.....B.....W
W...........W
WWWWWWWWWWWWW