.....B.....
P....B.....
..LWWWWWU..
.....B.....
....WWW....
B....P....B
....WWW....
.....B.....
..DWWWWWD..
.....B.....
.....B.....