P............
.............
...WWW.......
...BMB.......
...WWW.......
.............
.............