P............
.............
...WWW.......
...BGB.......
...WWW.......
.............
.............