.....B.....
.....B.....
P.LWWWWWU..
.....B.....
....WWW....
B....M....B
....WWW....
.....B.....
..DWWWWWD..
.....B.....
.....B.....