......B......
......W......
......B......
......W......
......B......
......W......
J.....W......
......W......
......B......
......W......
......B......
......W......
......B......
