......B......
.WWWWWWWWWWW.
......B......
...WWWWWWW...
......B......
.....WWW.....
......W......
.....WWW.....
......B......
...WWWWWWW...
......B......
.WWWWWWWWWWW.
......B......