......B......
.WWWWWWWWWWW.
......B......
...WWWWWWW...
......B......
.....WWW.....
.J....W......
.....WWW.....
......B......
...WWWWWWW...
......B......
.WWWWWWWWWWW.
......B......