......B......
.............
......B......
...WWWWWWW...
......B......
.....WWW.....
.J...........
.....WWW.....
......B......
...WWWWWWW...
......B......
.............
......B......